apnuñalar - to stab
agredir - to attack
huir - to escape (run away)
herir - to wound
la herida - wound (open bleeding wound or not yet treated)
la lesión - injury (medical term for a wound or treated injury)
el transeúnte - passerby (male)
en torno - around (time or place)
el testigo - witness (male)
la dotación - endowment (amount of money or crew, personnel)
tras - immediately after
la derrota - defeat
el atentado - offence (crime, assault, attempt)
las lágrimas - tears
la cifra - figure (number, code)
la reyerta - brawl (quarrel)
localizar - to locate
la droga - drug
el consentimiento - consent
la vivienda - housing (dwelling)
el damnificado - victim (male)
el varón - male
los antecedentes - record (criminal records or history)
tuvieron lugar - took place
la desaparición - disappearence
las sobras - leftovers (surplus, scraps of food)
al fin y al cabo - after all
insustituible - irreplaceable
remplazar - replace
soltar (o ue) - drop (release, let go)
saltar - to jump
mear - to pee
así como así - just like that
pilladar - to catch
remolino - swirl (whirlpool)
alucinar - to hallucinate, to deceive
la aroma - smell
el tramposo - cheat
de eso nada - nothing of that
enfadado - angry (spain)
insensato - senseless (foolish)
emprender - to undertake
el propósito - purpose
diantres - heck (why the heck are you ..)
atroz - atrocious
empapar - to soak
la cima - top (peak, summit, mountain top) 
retar - to challenge
callar - to shut up
ahorrar - to save (financial things or money)
luchar - to fight, struggle (unbrella term, includes metaphoric fights)
pelear - to fight (informal, physical or legal fights)
la rencilla - quarrel
dirimir - to settle
mediante - through
habitar - to inhabit (dwell)
animar - to cheer up
despedir - to say goodbye to
perezoso - lazy
acostumbrado - used to (usual or customary formal, adj.)
merendar - to have a picnic or a snack (to peep at some thing secretely)
el tamaño - size (clothing)
el carnet - card (identity card or drivers card etc)
el horario - schedule
la cita - appointment (a date)
el alojamiento - accommodation (lodgings)
vacío - empty
el pabellón - pavilion
la palmera - palm tree
mágico - magic (adj.)
flotar - to float
la cartuja - monastery (spanish specific monastery)
alargar - to extend (to lengthen)
averiguar - to find out


haré lo que sea que me pidas - I will do whatever you ask me to do
