más - more
apenas - hardly
también - also
ya - already
muy - very
básicamente - basically
después de - after
ahora - now
así - thus
bien - well
siempre - always
antes de - before
tan - so
cómo - how
sí - yes
hoy - today
entonces - then (therefore, so then)
luego - then (later on)
además - in addition to
casi - almost
poco - not much (very little)
menos - less
tanto - so much (so often)
sin embargo - however (nevertheless, less formal)
no obstante - however (nevertheless, more formal)
dentro de - inside of (place or thing)
adentro - inside (just inside, at home or other place)
afuera - outside
aquí - here (right here exactly)
acá - here (around here somewhere)
ahí - there (not close but not that far)
allí - there (something that is pretty far)
allá - there (way over there, completely out of reach)
todavía - still (not aún)
aún - still (not todavía)
aun - even
incluso - including (even)
hasta - until (to, till)
ni siquiera - not even
tampoco - nor (negative also)
cerca - near
apenas - barely
pronto - soon
fuera - outside
atrás - behind (just behind as a place)
detrás de - behind (something)
con cuidado - carefully
mucho - a lot
ayer - yesterday
normalmente - normally
encima de - on top of (above)
ruidosamente - loudly
tarde - afternoon
finalmente - finally
especialmente - especially
tal vez - maybe (2 word phrase)
quizás - maybe (perhaps, adv.)
a lo mejor - maybe (perhaps, for the better, i hope so)
acaso - maybe (perhaps, formal)
lejos - far
demasiado - too (too much)
mal - badly
perfectamente - perfectly
diariamente - daily
adelante - forward
igual - equal (the same, maybe)
primero - first
actualmente - currently
así como - as well as
precisamente - precisely
arriba - above (upstairs, up)
realmente - really (actually, adj.)
nunca - never (so far never, or happen to never do etc.)
jamás - never (very strong reason to never ever do etc.)
recién - just (recently, newly)
asimismo - likewise (also, in the same way)
difícilmente - with difficulty
alrededor - around (time or place)
por supuesto - of course
delante de - in front of (the front inside a place or ahead in place)
para nada - at all (not at all)
fácilmente - easily
simplemente - simply
directamente - directly
lentamente - slowly
por tanto - therefore
por lo menos - at least
principalmente - mainly
totalmente - totally
a menudo - often
probablemente - probably
prácticamente - practically
seguramente - surely
frecuentemente - frequently
aproximadamente - approximately
completamente - completely
posteriormente - later
nuevamente - again (newly or more formal again)
de nuevo - again (again from scratch or all over again)
otra vez - again (one more time, informal)
igualmente - equally
justo - just (fair, right, according to justice)
recientemente - recently
por favor - kindly
rápidamente - quickly
únicamente - only (uniquely)
respectivamente - respectively
inmediatamente - immediately
enseguida - right away
exactamente - exactly
claramente - clearly
generalmente - generally
perfectamente - perfectly
temprano - early
sobre - about (on, above, over)
entre - between
sin - without
desde - from
durante - during
contra - against
según - according to
de acuerdo - all right (I agree)
tras - immediately after
a través de - across (through)
a partir de - as of (as part of)
enfrente de - in front of (facing opposite of location or thing)
a pesar de - in spite of
pese a - despite
mediante - by means of
junto a - by (next to, close to, together with)
debido a - due to
de acuerdo con - in accordance with
en cuanto a - in regard to
acerca de - about (formal)
respecto a - with respect to
en torno a - around (revolved, centered around place or subject)
en lugar de - instead of